Hugo_Symbol	predisposition
BRCA1	BRCA1/2
BRCA2	BRCA1/2
CHEK2	CHEK2
APC	FAP
PTCH1	Gorlin syndrome
SUFU	Gorlin syndrome
TP53	Li-Fraumeni syndrome
PMS2	"CMMRD, Lynch syndrome"
MLH1	"CMMRD, Lynch syndrome"
MSH2	"CMMRD, Lynch syndrome"
MSH6	"CMMRD, Lynch syndrome"
NF1	NF-1
NF2	NF-2
RB1	Retinoblastoma
SMARCB1	RTPS
SMARCA4	RTPS
LZTR1	Schwannomatosis
TSC1	Tuberous Sclerosis
TSC2	Tuberous Sclerosis
VHL	Von Hippel-Lindau
NTHL1	Familial Adenomatous Polyposis
PTCH2	Gorlin syndrome